12
12
9 9 9 9 9 9 9 9 9 9 9 9
9 0 9 9 0 0 0 0 9 9 9 9
9 0 0 0 0 0 0 0 0 9 9 9
9 9 0 0 0 0 0 0 0 0 9 9
9 9 0 2 9 0 0 5 0 0 9 9
9 9 9 9 9 9 9 9 9 9 9 9
9 0 0 9 9 0 0 9 9 9 9 9
9 0 0 0 9 0 0 0 9 9 9 9
9 1 0 0 0 0 0 9 0 0 9 9
9 0 0 0 0 6 0 0 0 0 0 9
9 9 0 0 0 0 0 9 0 0 1 9
9 9 9 9 9 9 9 9 9 9 9 9

9 9 9 9 9 9 9 9 9 9 9 9
9 1 9 9 9 9 9 9 9 9 9 9
9 9 9 9 9 3 9 9 9 9 9 9
9 9 9 9 9 9 9 9 9 9 9 9
9 9 9 9 9 9 9 9 9 9 9 9
9 9 9 9 9 9 9 9 9 9 9 9
9 9 9 9 9 9 9 9 9 9 9 9
9 9 9 9 9 9 9 9 9 9 9 9
9 9 9 9 9 9 9 9 9 9 9 9
9 9 9 2 9 9 9 9 9 2 9 9
9 9 9 9 9 9 9 9 9 9 9 9
9 9 9 9 9 9 9 9 9 9 9 9
