7
7
3 3 3 3 3 3 3
3 9 9 9 9 9 9
9 9 2 4 0 0 9
9 0 0 4 0 0 9
9 9 9 0 0 9 9
3 3 9 9 9 9 3
3 3 3 3 3 3 3

9 9 9 9 9 9 9
9 9 9 9 9 9 9
9 9 9 9 9 9 9
9 1 3 9 9 9 9
9 9 9 9 9 9 9
9 9 9 9 9 9 9
9 9 9 9 9 9 9