7
7
3 9 9 9 3 3 3
3 9 0 9 9 3 3
9 9 0 0 9 9 9
9 0 0 0 0 1 9
9 9 9 0 9 9 9
3 3 9 9 9 3 3
3 3 3 3 3 3 3

0 9 9 9 0 0 0
0 9 0 9 9 0 0
9 9 4 0 9 9 9
9 1 4 0 2 0 9
9 9 9 0 9 9 9
0 0 9 9 9 0 0
0 0 0 0 0 0 0